##############
#..........##
#........###
#.....####
#...@###
#.......##
##########