...............#....
............#....#...
..........#........#..
.........@...........#
............#.........
...............#......
................#.....